LcdKeypad	KEYWORD1

LcdKeypadAdapter	KEYWORD1
handleKeyChanged	KEYWORD2
setBackLightOn	KEYWORD2
handleButtons	KEYWORD2
getCurrentKey	KEYWORD2
isNoKey	KEYWORD2
isUpKey	KEYWORD2
isDownKey	KEYWORD2
isSelectKey	KEYWORD2
isLeftKey	KEYWORD2
isRightKey	KEYWORD2
attachAdapter	KEYWORD2
adapter	KEYWORD2
begin	KEYWORD2
clear	KEYWORD2
home	KEYWORD2
noDisplay	KEYWORD2
display	KEYWORD2
noBlink	KEYWORD2
blink	KEYWORD2
noCursor	KEYWORD2
cursor	KEYWORD2
scrollDisplayLeft	KEYWORD2
scrollDisplayRight	KEYWORD2
leftToRight	KEYWORD2
rightToLeft	KEYWORD2
autoscroll	KEYWORD2
noAutoscroll	KEYWORD2
createChar	KEYWORD2
setCursor	KEYWORD2
setBacklight	KEYWORD2
write	KEYWORD2
command	KEYWORD2
setMCPType	KEYWORD2

Key	DATA_TYPE
NO_KEY	LITERAL1
SELECT_KEY	LITERAL1
LEFT_KEY	LITERAL1
UP_KEY	LITERAL1
DOWN_KEY	LITERAL1
RIGHT_KEY	LITERAL1

LcdBacklightColor	DATA_TYPE
LCDBL_OFF	LITERAL1
LCDBL_RED	LITERAL1
LCDBL_GREEN	LITERAL1
LCDBL_YELLOW	LITERAL1
LCDBL_BLUE	LITERAL1
LCDBL_VIOLET	LITERAL1
LCDBL_TEAL	LITERAL1
LCDBL_WHITE	LITERAL1

MCPType	DATA_TYPE
MCPT_MCP23008	LITERAL1
MCPT_MCP23017	LITERAL1

LcdDeviceType	DATA_TYPE
LCD_DT_TWI2	LITERAL1
LCD_DT_CRYST	LITERAL1

LcdCharDots	DATA_TYPE
LCDC_5x8DOTS	LITERAL1
LCDC_5x10DOTS	LITERAL1
